..........
.T........
.^........
..........
__________
..........
..........
..........
..........
..........