._..._....
._..._....
._____....
._........
._........
._...._...
._...__...
__________
._........
._........