..........
..........
..........
..........
..........
......_...
.....__...
__________
..........
..........