.T.T.T.T.T.T.T.T.
^.^.^.^.^.^.^.^.^
_________________
.T.T.T.T.T.T.T.T.
^.^.^.^.^.^.^.^.^
_________________
.T.T.T.T.T.T.T.T.
^.^.^.^.^.^.^.^.^
_________________
.T.T.T.T.T.T.T.T.
^.^.^.^.^.^.^.^.^
_________________
.T.T.T.T.T.T.T.T.
^.^.^.^.^.^.^.^.^
_________________
.T.T.T.T.T.T.T.T.
^.^.^.^.^.^.^.^.^