..........
....T.....
...T......
...T......
...T..^...
..........
.^...^....
....^.....
..........
..........