^^^TT....^^^^^^
^^TT......^^T^^
^............T^
..............T
^......________
________......^
T............^^
^T..........^^^
^^^...^....^^^^
^^^^.^^^.^^^^^^